**********
*        *
* * ******
* *      *
* ** * ***
* *  * * *
* *      *
* *** ****
* *      *
*********
